NO ./textures/authors/author.xpm
WE ./textures/authors/author.xpm
SO ./textures/authors/author.xpm
EA ./textures/authors/author.xpm
F 255,255,255
C 0,0,0

1111111111111111111111111
1000000000000000000000001
1000000000000000000000001
1000000000100000001110001
1000000001100000100100001
1000000000110001001000001
1000000000011110000100001
1N00000000000000000001001
1111111111111111111111111