NO ./graphics/brick_walls/brickwall1.xpm
SO ./graphics/brick_walls/brickwall2.xpm
WE ./graphics/brick_walls/brickwall3.xpm
EA ./graphics/brick_walls/brickwall4.xpm
F 15,6,0
C 200,60,1

111111
100001
1E0001
111111