NO ./graphics/brick_walls/brickwall1.xpm
SO ./graphics/brick_walls/brickwall2.xpm
WE ./graphics/brick_walls/brickwall3.xpm
EA ./graphics/brick_walls/brickwall4.xpm
F 255,255,255
C 0,0,0
111111
100001
100001
10N001
111111