NO ./graphics/brick_walls/brickwall1.xpm             
SO ./graphics/brick_walls/brickwall2.xpm
WE ./graphics/brick_walls/brickwall3.xpm      
EA ./graphics/brick_walls/brickwall4.xpm

F 86,200,133
C 133,200,86                 


111111111111111111111
1000100111010101101011
101000111111011110111
1110100000000000011                     
101N1101100101010011
10000110100101110001
10011000010000001001
10100100000001100001
10101101100010010101
11000001010101001111
11110101110111001001
10010000111011011011
10000010100110011001
11111111111111111111
10110001001011001111
10011110011100001111
10000001001110100001
11111100001111010011
10001101101100101001
1111111111111111111
